00001000000000000!
00001000000000111!
00001111000000100!
00000001000001100!
00000001000001000!
00011111000001000!
00010000000001000!
00011111111111000!